00 00 00 00 00 00 00 00
00 00 00 00 00 00 00 00
00 00 00 00 00 00 00 00
00 00 00 00 00 00 00 00
00 00 00 00 00 00 00 00
00 00 00 00 00 00 00 00
00 00 00 00 00 00 00 00

f9 21 40 00 00 00 00 00
39 21 40 00 00 00 00 00
31 21 40 00 00 00 00 00

48 00 00 00 00 00 00 00

70 22 40 00 00 00 00 00
31 22 40 00 00 00 00 00
7c 22 40 00 00 00 00 00

48 21 40 00 00 00 00 00

39 21 40 00 00 00 00 00

3a 20 40 00 00 00 00 00

37 66 30 35 61 31 38 35
00
